4uuuuuuuuuuuuuuuuuu4
lp0..............0pr
l0(==============)0r
l0v0...000000...0v0r
l.00(===>00<===)00.r
l.00|0........0|00.r
0.^000.(====).000^.0
0.|000.|0000|.000|.0
0.v000.[====].000v.0
l.00|000....000|00.r
l.00[===>00<===]00.r
l0^0...000000...0^0r
l0[==============]0r
lp0..............0pr
1dddddddddddddddddd2