4uuuuuuuuuuuuuuuuuu4
l000000000000000000r
l00000000..0000p000r
l000000000000000000r
l00000<==s>00000000r
l00000000|000000000r
000000000f===>000000
000000000v0000000000
00000000000000000000
l0000.0.0.0^0.0.000r
l0000000000|0000000r
l00<=)000<=+=>00000r
l0000|00000|0000000r
l0p00[=====]0000000r
1dddddddddddddddddd2