3uuuuuuuuuuuuuuuuuu4
l000000000000000000r
l000000000000000000r
l000000000000000000r
l000000000000000000r
l000000000000000000r
l000000000000000000r
l000000rl0000000000r
l000000000000000000r
l000000000000000000r
l000000000000000000r
l00000000%mmm*00000r
l000000000000000000r
l000000000000000000r
1dddddddddddddddddd2